1111111111111111111111111111111111
1E0000010010000C00000C000000000001
101001010010000010100100s000010101
1010010010101010001001000000010101
1P0000000C10C000000000 000000000C1
1111111111111111111111111111111111
