1111111111111
1001000CC00C1
1000011111001
1P00110000011
1000000000011
111110000E111
1100000000011
1111111111111