1111111111111
1001000CC00C1
1000011111001
1000110000011
1P00000000011
111110000E111
1100000000011
1111111111111