111111
1P0001
10C011
100E11
111111