111111
1P0011
10C011
10E011
111111