11111111111111111111111
1C010000000000000C1C011
11010000000000000010001
10010111111111111010101
10E101C1C000000C1000101
10000101110111011111101
110001010001C0000000001
11000100000100001111111
110001010001110010000C1
1C0011C111C1000000000P1
11111111111111111111111
