1111111111111
1C01C00000011
1100P01100001
100001E000011
1111111111111
